0 0 0 0 0 0 0 0 0 0
0 0 0 0 0 0 0 0 0 0
0 0 0 0 0 0 0 0 0 0
0 0 0 0 0 0 0 0 0 0
0 0 0 0 99 99 99 99 99 0
0 0 0 0 0 99 99 99 0 0
99 99 99 99 99 99 99 99 99 99
5 5 5 5 5 5 99 5 5 5
5 5 5 5 5 5 99 5 5 5
5 5 5 5 5 5 99 5 5 5
5 5 5 5 5 5 99 5 5 5
5 5 5 5 5 5 99 5 5 5