1 2 3 4 5 99 5 4 3 2 1
2 3 4 5 99 99 99 5 4 3 2
3 4 5 99 99 2 99 99 5 4 3
4 5 99 99 2 3 2 99 99 5 4
5 99 99 2 3 4 3 2 99 99 5
99 99 2 3 4 5 4 3 2 99 99
99 2 3 4 5 99 5 4 3 2 99