1 2 3 4 5 99 5 4 3 2 1
2 3 4 5 99 1 99 5 4 3 2
3 4 5 99 1 2 1 99 5 4 3
4 5 99 1 2 3 2 1 99 5 4
5 99 1 2 3 4 3 2 1 99 5
99 1 2 3 4 5 4 3 2 1 99
1 2 3 4 5 99 5 4 3 2 1